111111111111111
111110000C00011
111100000000001
1100000P00E1111
1000000CC001111
111111111111111