11111
1P0Z1
1@001
1C0E1
11111
