11111
1P0C1
10E01
1C0E1
11111
