11111111111111111111
111110000C0000000011
11110000000000000001
1100000P00E001111111
1000000CC00000C01111
11111C00000000000001
110000C00000CC111111
11111111111111111111