11111111111111111111
111110000C0000000011
11110001001000000001
1100001PCE1010011111
10000001100000C01111
11111C00000000000001
110000C00000CC111111
11111111111111111111